111111
1P0C00
100001
1C0E01
111111

