111111
1P0C01
10C001
100E01
111111