111111
1P0C11
111011
1E0011
111111
